000000000000000
211111111011110
010000011110000
011111010110110
000101000000010
011101111101010
010001000101010
010111011101010
010111011001010
010000001111110
011101110100000
010100010111010
010111010101010
011101011101113
000000000000000